11g1111111111
10010000000C1
1101011111001
1P0011E000001
1111111111111