111111111111111
1P0000C1C01C1E1
111100001010001
1C011C100000101
100001C01110001
10110011C1C1101
100C10C00000001
111111111111111