1111111111111
1001C000C00C1
111110E111001
1P0C111000001
1111111111111