11111111111111111111
11000CC000000100C011
11001C00E00C00000011
1110CC0000C0000C0111
10001PC0110010000001
11111111111111111111