11111111111111111111
11000C00000000000011
110010100C1C00000011
1100CP0000E110000011
10001000100010000001
11111111111111111111