111111111111111
11001C000111111
1111110E1111111
1P01C1110111111
111111111111111