1111111111111111111111111111111111111
1010000000100000P00010C00000000010001
1000001010101000101010001000101010C01
1010000010001010C01000101010001010001
101010000010100010001C001010101010101
10001010000010101C1000100000100010001
1000001000100010000010100010101C00101
100010001010100000001000101C001010001
1010000010101010001000000010001C10001
100010101010101010101000C000101010001
1000C01010001010100000100000101000101
100010000010001000101010001010C010001
10100000000010000010000000100C0010001
101000100000101000001C000000101010001
101C100010101000001000000010100010101
10001010100C0010000010000010100010101
1000101000000C00101000101000001010101
1010000000000000E010100C0000100010001
101000001010000010001010000C100000001
101000101000000010100010101000C000001
1000001000100000C00010000000000000101
1111111111111111111111111111111111111